}}}}}}}}}}}}}}}}}}}}}}}}}}}}}}}}}}}}}}}}}}}}}}}}}}}}}}}}}}}}}}}}}}}}}}}}}}}}
}}}}}}}}}}}}}}........}}}}}}}}}}}}}}}}}}}}}}}..}}}.....}}}}}}}}}}}----|}}}}}
}}}}}}..----------F-.....}}}}}}}}}}}}}}}}..---...}}}}....T.}}}}}}}....|}}}}}
}}}.....|...F......S}}}}....}}}}}}}...}}.....|}}.}}}}}}}......}}}}|......}}}
}}}.....+...|..{...|}}}}}}}}}}}}.....}}}}|...|}}}}}}}}}}}.}}}}}}}}----.}}}}}
}}......|...|......|}}}}}}}}}......}}}}}}|.......}}}}}}}}}}}}}..}}}}}...}}}}
}}|-+--F|-+--....|F|-|}}}}}....}}}....}}}-----}}.....}}}}}}}......}}}}.}}}}}
}}|...}}|...|....|}}}|}}}}}}}..}}}}}}}}}}}}}}}}}}}}....}}}}}}}}....T.}}}}}}}
}}|...}}F...+....F}}}}}}}..}}}}}}}}}}}}}}...}}}}}}}}}}}}}}}}}}}}}}....}}..}}
}}|...}}|...|....|}}}|}....}}}}}}....}}}...}}}}}...}}}}}}}}}}}}}}}}}.....}}}
}}--+--F|-+--....-F|-|....}}}}}}}}}}.T...}}}}....---}}}}}}}}}}}}}}}}}}}}}}}}
}}......|...|......|}}}}}.}}}}}}}}}....}}}}}}}.....|}}}}}}}}}.}}}}}}}}}}}}}}
}}}}....+...|..{...|.}}}}}}}}}}}}}}}}}}}}}}}}}}.|..|}}}}}}}......}}}}...}}}}
}}}}}}..|...F......|...}}}}}}}}}}..---}}}}}}}}}}--.-}}}}}....}}}}}}....}}}}}
}}}}}}}}-----S----F|....}}}}}}}}}|...|}}}}}}}}}}}}...}}}}}}...}}}}}}..}}}}}}
}}}}}}}}}..............T...}}}}}.|.......}}}}}}}}}}}}}}..}...}.}}}}....}}}}}
}}}}}}}}}}....}}}}...}...}}}}}.......|.}}}}}}}}}}}}}}.......}}}}}}}}}...}}}}
}}}}}}}}}}..}}}}}}}}}}.}}}}}}}}}}-..--.}}}}}}}}..}}}}}}..T...}}}..}}}}}}}}}}
}}}}}}}}}...}}}}}}}}}}}}}}}}}}}}}}}...}}}}}}}....}}}}}}}.}}}..}}}...}}}}}}}}
}}}}}}}}}}}}}}}}}}}}}}}}}}}}}}}}}}}}}.}}}}}}....}}}}}}}}}}}}}}}}}}}...}}}}}}
}}}}}}}}}}}}}}}}}}}}}}}}}}}}}}}}}}}}}}}}}}}}}}}}}}}}}}}}}}}}}}}}}}}}}}}}}}}}