                                                                               
                                                                               
                --------------                                                 
                |............|             -------                             
          -------............-----         |.....|                             
          |......................|        --.....|            ---------        
       ----....^^^^^^^^^^^.......---------|......----         |.......|        
       |.......^-SSSSSSS-^.........|......+.........|     ------+---..|        
     ---.......^S.......S^.........--S----|.........|     |........|..|        
     |.........^S..._...S^............|   |.........------|..----------        
     |.........^S.......S^.........----   |..........|....|..|......|          
     |.........^S.......S^.........|      --.......----+---S---S--..|          
     |.........^-SSSSSSS-^.........|       |.......|.............|..|          
     ---.......^^^^^^^^^^^.........|       -----+-------S---------S---         
       |...........................|          |...| |......|    |....---       
       ----.....................----          |...---....---  ---......|       
          |.....................|             |..........|    |..<..----       
          -------...........-----             --...-------    |.....|          
                |...........|                  |...|          |.....|          
                -------------                  -----          -------          
                                                                               