----------------------------------------------------------------------------
|>.^S.|..|.....|  |.....-|      |................|   |......^........| |...|
|---|.|.--.---.|  |......--- ----..........-----.-----....---........---.-.|
|   |.|.|..| |.| --........HHH.............|   |.......---| |-...........--|
|   |...S..| |.| |.......-----.......------|   |--------..---......------- |
|----------- |.| |-......| |....|...-- |...-----................----       |
|.....S....---.| |.......| |....|...|  |..............-----------          |
|.....|.|......| |.....--- |......---  |....---.......|                    |
|.....|.|------| |....--   --....-- |---HHHH- ----HHHH---------------      |
|.....|--......---...-|     |...--  |.......|    |..................|      |
|.._.......||...H....-|    --...|   |.......|    |...||.............|      |
|.....|...-||-..H.....------....|   |.......---- |...||.............--     |
|.....|--......---...^.....H.--------..........| |.......---------...--    |
|.....| |HHHHHH| |--.......--|   |.........----- -----....| |.|  |....---  |
|.....| |......--| ------..| |----.........|       |.--------.-- |-.....---|
|------ |........|  |.|....| |.....----....---------...........---.........|
|       |........|  |...|..| |.....|  |-.............--------...........---|
|       --.....-----------^| |....-----.....----------     |......<..----  |
|        |..|..............| |.|..........|.|              |.|........|    |
----------------------------------------------------------------------------