}}}}}}}}}}}}}}}}}}}}}}}}}}}}}}}}}}}}}}}}}}}}}}}}}}}}}}}}}}}}}}}}}}}}}}}}}}}
}}}}}}}}}}}}}}}}}}}}}}}}}}}}}}}}}}}}}}}}}}}}}}}}}}}}}}}}}}}}}}}}}}}}}}}}}}}
}}.}}}}}..}}}}}......}}}}}}}}}}}}}}}}}}}}}}}}}}}}}}}}}}}}}}}....}}}...}}}}}
}...}}.....}}}}}....}}}}}}}}}}}}}}}}}}}}}}}}}}}}}}}}}}}}}}}...............}
}....}}}}}}}}}}....}}}..}}}}}}}}}}}.......}}}}}}}}}}}}}}}}..}}.....}}}...}}
}....}}}}}}}}.....}}}}..}}}}}}.................}}}}}}}}}}}.}}}}.....}}...}}
}....}}}}}}}}}}}}.}}}}.}}}}}}.-----------------.}}}}}}}}}}}}}}}}}.........}
}....}}}}}}}}}}}}}}}}}}.}}}...|...............S...}}}}}}}}}}}}}}}}}}}....}}
}.....}.}}....}}}}}}}}}.}}....--------+--------....}}}}}}..}}}}}}}}}}}...}}
}......}}}}..}}}}}}}}}}}}}........|.......|........}}}}}....}}}}}}}}}}}}}}}
}.....}}}}}}}}}}}}}}}}}}}}........|.>.....|........}}}}}...}}}}}}}}}.}}}}}}
}.....}}}}}}}}}}}}}}}}}}}}....--------+--------....}}}}}}.}.}}}}}}}}}}}}}}}
}......}}}}}}}}}}}}}}}}}}}}...S...............|...}}}}}}}}}}}}}}}}}.}}}}}}}
}....<..}}}}}}}..}}}}}}}}}}}}.-----------------.}}}}}}}}}}}}}}}}}....}}}}}}
}........}}.}}....}}}}}}}}}}}}.................}}}}}..}}}}}}}}}.......}}}}}
}.......}}}}}}}......}}}}}}}}}}}}}}.......}}}}}}}}}.....}}}}}}...}}..}}}}}}
}.....}}}}}}}}}}}.....}}}}}}}}}}}}}}}}}}}}}}.}}}}}}}..}}}}}}}}}}....}}}}}}}
}}..}}}}}}}}}}}}}....}}}}}}}}}}}}}}}}}}}}}}...}}..}}}}}}}.}}.}}}}..}}}}}}}}
}}}}}}}}}}}}}}}}}}}}}}}}}}}}}}}}}}}}}}}}}}}}}}}}}}}}}}}}}}}}}}}}}}}}}}}}}}}
}}}}}}}}}}}}}}}}}}}}}}}}}}}}}}}}}}}}}}}}}}}}}}}}}}}}}}}}}}}}}}}}}}}}}}}}}}}