}}}}}}}}}}}}}}}}}}}}}}}}}}}}}}}}}}}}}}}}}}}}}}}}}}}}}}}}}}}}}}}}}}}}}}}}}}}
}}}}}}}}}}}}}}}}}}}}}}}}}}}}}}}}}}}}}}}}}}}}}}}}}}}}}}}}}}}}}}}}}}}}}}}}}}}
}------}}}}}}}}}}}}}}}}}}}}}}}}}}}}}}}}}}}}}}-------}}}}}}}}--------------}
}|....|}}}}}}}}}..}.}}..}}}}}}}}}}}}}..}}}}}}|.....--}}}}}}}|............|}
}|..0.|.}}}}}}}}}}}.}...}}..}}}}}}}}}}}}}}}}}|--......}}}}}.|............|}
}S....|.}}}}}}---}}}}}}}}}}}}}}}}}}}}}}}}}}---...|..|}}}}}}.S..----------|}
}|....|.}}}}}}|...}}}}}}}}}.}}...}.}}}}.}}}......----}}}}}}.|............|}
}|....|.}}}}}}|....--}}}}}}}}}}}}}}}}}}}}}}----...-|}}}}}}}.|..--------+-|}
}|....|.}}}}}}}......}}}}...}}}}}}.}}}}}}}}}}}---..|--}}}}}.|..|..S...|..|}
}|..<.|.}}}}}}-....|}}}}}}}------}}}}}}}}}}}}}}|...|0|}}}}}.|..|..|...|..|}
}|....|.}}}}}}}}}---}}}}}}}........}}}}}}}}}}---.|....}}}}}.|..|..|.>.|..|}
}|....|.}}}}}}}}}}}}}}}}}}|....|...|}}}}}}}}--...|---.}}}}}.|..|..|...|..|}
}|.^..|.}}}}}}..}}}}}}}}}}---..--------}}}}}|..---}}}}}}}}}.|..|..-------|}
}|...}|...}}}.}}}}}}...}}}}}|-..........}}}}..--}}}}}}}}}}}.|..|.........|}
}|...}S...}}.}}}}}}}}}}}}}}}|..--------}}}}}}}}}}}}}}...}}}.|..--------..S}
}|...}|...}}}}}}}..}}}}}}----..|....|}}}}}}}}}}}}}}}}}..}}}.|............|}
}|....|}}}}}....}}}}..}}.|.......----}}......}}}}}}.......}}|............|}
}------}}}}}}}}}}}}}}}}}}---------}}}}}}}}}}}}}}}}}}}}}}}}}}--------------}
}}}}}}}}}}}}}}}}}}}}}}}}}}}}}}}}}}}}}}}}}}}}}}}}}}}}}}}}}}}}}}}}}}}}}}}}}}}
}}}}}}}}}}}}}}}}}}}}}}}}}}}}}}}}}}}}}}}}}}}}}}}}}}}}}}}}}}}}}}}}}}}}}}}}}}}