-----------------------------------------------------                        
|.................H...H.............................|                        
|.----------S--.---...---------------------------|..|                        
|.||----   |.|--- |...|..........................|..|                        
|.||...| ---.-.|---...|.............<............H..|                **      
|.||...--|.....|....-H-..........................|..D.               **      
|.||.....|-S-..|....|............................|..|..                      
|.|----..|*.|..---..|----------------------------|HH|-.                      
|.|   |..|*.|....|..................................|...                     
|.|   |..|*.|-----..------------------------------..|....                    
|.-----..---|.......|-----------------------     |..|.....                   
|...........|----.--|......................|     |..|.......                 
-------HH---|...|.| --------------------.|.-------..|.....|..                
-------HH----.{.|.|---------------------.|..........|.....|....              
|...............|.S......................|-------------HH-----...            
|.---------------.|---------------------.|...................H.....          
|.................|                    |.....................|........       
-------------------                    --------------------------------      